1 0 0 0 0 0 0 0 0 0 0 0 0 0 0 0 0 0 0 0 0 0 0 0 0 0 0 1 1 1 1 1 1 1
1 2 2 0 2 2 2 0 2 2 2 0 3 3 3 3 3 3 3 3 3 3 3 3 3 3 3 1 1 1 1 1 1 1
1 4 4 0 4 4 4 0 4 4 4 0 12 12 12 12 33 12 12 12 46 12 12 12 12 12 12 1 1 1 1 1 1 1
1 29 29 0 29 29 29 0 29 29 29 0 26 26 26 26 30 26 26 26 31 26 26 26 26 26 26 1 1 1 1 1 1 1
1 14 14 0 14 14 14 0 14 14 14 0 6 6 6 6 34 6 6 6 35 6 6 6 6 6 6 1 1 1 1 1 1 1
1 14 2 2 2 14 14 2 2 14 14 0 6 6 6 6 34 6 6 6 35 6 6 6 6 6 6 1 1 1 1 1 1 1
1 5 4 4 4 5 5 4 4 5 5 0 6 6 6 6 34 6 6 6 35 6 6 6 6 6 6 1 1 1 1 1 1 1
1 5 15 15 15 5 5 15 15 5 5 0 44 44 42 6 36 6 6 6 37 6 6 47 44 44 44 3 3 7 7 3 3 1
1 5 5 5 5 5 5 5 5 5 5 0 45 45 43 6 38 6 6 6 39 6 6 48 45 45 45 3 3 7 7 3 3 1
1 5 5 5 5 5 5 5 5 5 5 0 6 6 6 6 6 6 6 6 6 6 6 6 6 6 6 32 32 32 32 32 32 1
1 0 0 0 0 5 5 0 0 0 0 0 6 6 6 6 6 6 6 6 6 6 6 6 6 6 6 6 6 6 6 6 6 1
1 7 7 7 7 13 13 7 7 7 7 0 6 6 6 6 6 6 6 6 6 6 6 6 6 6 6 6 6 6 6 6 6 1
1 8 8 8 8 9 9 8 8 8 8 0 6 6 6 6 6 6 6 6 6 6 6 6 6 6 6 6 6 6 6 6 6 1
1 28 28 28 28 9 9 28 28 28 28 0 6 6 6 6 6 6 6 6 6 6 6 6 6 6 6 6 6 6 6 6 6 1
1 9 9 9 9 9 9 9 9 9 9 0 0 0 6 0 0 0 0 6 0 0 0 0 0 0 6 6 0 0 0 0 0 1
1 9 9 9 9 9 9 9 9 9 9 7 7 7 11 7 7 7 7 11 7 7 7 7 7 7 11 11 7 7 7 7 7 1
1 9 9 9 9 9 9 9 9 9 9 16 8 8 9 8 8 8 8 9 8 8 17 8 8 8 9 9 8 8 8 8 8 1
1 9 9 9 9 9 9 9 9 9 9 18 27 27 9 27 27 27 27 9 27 27 19 27 27 27 9 9 27 27 27 27 27 1
1 9 9 9 9 9 9 9 9 9 9 18 9 9 9 9 9 9 9 9 9 9 19 9 9 9 9 9 9 9 9 9 9 1
1 9 9 9 9 9 9 9 9 9 9 20 22 23 9 9 9 9 9 9 24 22 21 9 9 9 9 9 9 9 9 9 9 1
1 9 9 9 9 9 9 9 9 9 9 9 9 20 22 25 22 22 25 22 21 9 9 9 9 9 9 9 9 9 9 9 9 1
1 9 9 9 9 9 9 9 9 9 9 9 9 9 9 9 9 9 9 9 9 9 9 9 9 9 9 9 9 9 9 9 9 1
1 9 9 9 9 9 9 9 9 9 9 9 9 9 9 9 9 9 9 9 9 9 9 9 9 9 9 9 9 9 9 9 9 1
1 0 0 0 0 0 0 0 0 0 9 9 9 9 9 9 9 9 9 9 9 9 9 9 0 0 0 0 0 0 0 0 0 1
1 7 7 7 7 7 7 7 7 7 9 9 9 9 9 9 9 9 9 9 9 9 9 9 7 7 7 7 7 7 7 7 7 1
1 8 8 8 8 8 8 8 8 8 9 9 9 9 9 9 9 9 9 9 9 9 9 9 8 8 8 8 8 8 8 8 8 1
1 28 28 28 28 28 28 28 28 28 9 9 9 9 9 9 9 9 9 9 9 9 9 9 28 28 28 28 28 28 28 28 28 1
1 9 9 9 9 9 9 9 9 9 9 9 9 9 9 9 9 9 9 9 9 9 9 9 9 9 9 9 9 9 9 9 9 1
1 9 9 9 9 9 9 9 9 9 9 9 9 9 9 9 9 9 9 9 9 9 9 9 9 9 9 9 9 9 9 9 9 1
1 9 9 9 9 9 9 9 9 9 9 9 9 9 9 9 9 9 9 9 9 9 9 9 9 9 9 9 9 9 9 9 9 1
1 9 9 9 9 9 9 9 9 9 9 9 9 9 9 9 9 9 9 9 9 9 9 9 9 9 9 9 9 9 9 9 9 1
1 9 9 9 9 9 9 9 9 9 9 9 9 9 9 9 9 9 9 9 9 9 9 9 9 9 9 9 9 9 9 9 9 1
1 1 1 1 1 1 1 1 1 1 1 1 1 1 1 1 1 1 1 1 1 1 1 1 1 1 1 1 1 1 1 1 1 1 